#########
#       #
#       ####
## #### #  #
## #A##    #
# @@@ @  @@#
#  # ## @  #
#  # ##  @ ####
####  @@@ @#  #
 #   ##   oooo#
 # #   # #oo o#
 #   # # ##ooo#
 ##### @  #ooo#
     ##   #####
      #####