############
##     ##  #
##   @   @ #
#### ## @@ #
#   @ #    #
# @@@ # ####
#   # # @ ##
#  #  #  @ #
# @# @#    #
#   oo# ####
####oo @ #A#
#ooooo# @# #
##oooo#  @ #
###oo##    #
############