#########
#   A   #
#       #
#   @@  #
#   oo  #
#       #
#########