#########
#A      #
#     @ #
#       #
#   o   #
#       #
#########