#########
#A      #
#    @  #
#       #
#       #
#  o    #
#########