#########
#      o#
#       #
#    @  #
#       #
#  A    #
#########